11111111111111111111111111111111111111111111111111111111
101P0000000000000000000000000000000000000000000000000001
101C0000000000000000000000000000000000000000000000000001
101C0000000000000000000000000000000000000000000000000001
101C0000000000000000000000000000000000000000000000000001
101C0000000000000000000000000000000000000000000000000001
101C0000000000000000000000000000000000000000000000000001
101C0000000000000000000000000000000000000000000000000001
101C0000000000000000000000000000000000000000000000000001
101C0000000000000000000000000000000000000000000000000001
101C0000000000000000000000000000000000000000000000000001
101C0000000000000000000000000000000000000000000000000001
101C0000000000000000000000000000000000000000000000000001
101C0000000000000000000000000000000000000000000000000001
101C0000000000000000000000000000000000000000000000000001
101C0000000000000000000000000000000000000000000000000001
101C0000000000000000000000000000000000000000000000000001
101C0000000000000000000000000000000000000000000000000001
101C0000000000000000000000000000000000000000000000000001
101C0000000000000000000000000000000000000000000000000001
101C0000000000000000000000000000000000000000000000000001
101C0000000000000000000000000000000000000000000000000001
101C0000000000000000000000000000000000000000000000000001
101C0000000000000000000000000000000000000000000000000001
101C0000000000000000000000000000000000000000000000000001
101C0000000000000000000000000000000000000000000000000001
101C0000000000000000000000000000000000000000000000000001
101C0000000000000000000000000000000000000000000000000001
101C0000000000000000000000000000000000000000000000000001
101C0000000000000000000000000000000000000000000000000001
101C0000000000000000000000000000000000000000000000000001
101C0000000000000000000000000000000000000000000000000001
101C0000000000000000000000000000000000000000000000000001
101C0000000000000000000000000000000000000000000000000001
101C0000000000000000000000000000000000000000000000000001
101C0000000000000000000000000000000000000000000000000001
101C0000000000000000000000000000000000000000000000000001
101C0000000000000000000000000000000000000000000000000001
101C0000000000000000000000000000000000000000000000000001
101C0000000000000000000000000000000000000000000000000001
101C0000000000000000000000000000000000000000000000000001
101C0000000000000000000000000000000000000000000000000001
101C0000000000000000000000000000000000000000000000000001
101C0000000000000000000000000000000000000000000000000001
101C0000000000000000000000000000000000000000000000000001
101C0000000000000000000000000000000000000000000000000001
101C0000000000000000000000000000000000000000000000000001
101C0000000000000000000000000000000000000000000000000001
101C0000000000000000000000000000000000000000000000000001
101C0000000000000000000000000000000000000000000000000001
101C0000000000000000000000000000000000000000000000000001
101C0000000000000000000000000000000000000000000000000001
101C0000000000000000000000000000000000000000000000000001
101C0000000000000000000000000000000000000000000000000001
101C0000000000000000000000000000000000000000000000000001
101C0000000000000000000000000000000000000000000000000001
101C0000000000000000000000000000000000000000000000000001
101C0000000000000000000000000000000000000000000000000001
101C0000000000000000000000000000000000000000000000000001
101C0000000000000000000000000000000000000000000000000001
101C0000000000000000000000000000000000000000000000000001
101C0000000000000000000000000000000000000000000000000001
101C0000000000000000000000000000000000000000000000000001
101C0000000000000000000000000000000000000000000000000001
101C0000000000000000000000000000000000000000000000000001
101C0000000000000000000000000000000000000000000000000001
101C0000000000000000000000000000000000000000000000000001
101C0000000000000000000000000000000000000000000000000001
101C0000000000000000000000000000000000000000000000000001
101C0000000000000000000000000000000000000000000000000001
101C0000000000000000000000000000000000000000000000000001
101C0000000000000000000000000000000000000000000000000001
101C0000000000000000000000000000000000000000000000000001
101C0000000000000000000000000000000000000000000000000001
101C0000000000000000000000000000000000000000000000000001
101C0000000000000000000000000000000000000000000000000001
101C0000000000000000000000000000000000000000000000000001
101C0000000000000000000000000000000000000000000000000001
101C0000000000000000000000000000000000000000000000000001
101C0000000000000000000000000000000000000000000000000001
101C0000000000000000000000000000000000000000000000000001
101C0000000000000000000000000000000000000000000000000001
101C0000000000000000000000000000000000000000000000000001
101C0000000000000000000000000000000000000000000000000001
101C0000000000000000000000000000000000000000000000000001
101C0000000000000000000000000000000000000000000000000001
101C0000000000000000000000000000000000000000000000000001
101C0000000000000000000000000000000000000000000000000001
101C0000000000000000000000000000000000000000000000000001
101C0000000000000000000000000000000000000000000000000001
101C0000000000000000000000000000000000000000000000000001
101C0000000000000000000000000000000000000000000000000001
101C0000000000000000000000000000000000000000000000000001
101C0000000000000000000000000000000000000000000000000001
101C0000000000000000000000000000000000000000000000000001
101C0000000000000000000000000000000000000000000000000001
101C0000000000000000000000000000000000000000000000000001
101C0000000000000000000000000000000000000000000000000001
101C0000000000000000000000000000000000000000000000000001
101C0000000000000000000000000000000000000000000000000001
101C0000000000000000000000000000000000000000000000000001
101C0000000000000000000000000000000000000000000000000001
101C0000000000000000000000000000000000000000000000000001
101C0000000000000000000000000000000000000000000000000001
101C0000000000000000000000000000000000000000000000000001
101C0000000000000000000000000000000000000000000000000001
101C0000000000000000000000000000000000000000000000000001
101C0000000000000000000000000000000000000000000000000001
101C0000000000000000000000000000000000000000000000000001
101C0000000000000000000000000000000000000000000000000001
101C0000000000000000000000000000000000000000000000000001
101C0000000000000000000000000000000000000000000000000001
101C0000000000000000000000000000000000000000000000000001
101C0000000000000000000000000000000000000000000000000001
101C0000000000000000000000000000000000000000000000000001
101C0000000000000000000000000000000000000000000000000001
101C0000000000000000000000000000000000000000000000000001
101C0000000000000000000000000000000000000000000000000001
101C0000000000000000000000000000000000000000000000000001
101C0000000000000000000000000000000000000000000000000001
101C0000000000000000000000000000000000000000000000000001
101C0000000000000000000000000000000000000000000000000001
101C0000000000000000000000000000000000000000000000000001
101C0000000000000000000000000000000000000000000000000001
101C0000000000000000000000000000000000000000000000000001
101C0000000000000000000000000000000000000000000000000001
101C0000000000000000000000000000000000000000000000000001
101C0000000000000000000000000000000000000000000000000001
101C0000000000000000000000000000000000000000000000000001
101C0000000000000000000000000000000000000000000000000001
101C0000000000000000000000000000000000000000000000000001
101C0000000000000000000000000000000000000000000000000001
101C0000000000000000000000000000000000000000000000000001
101C0000000000000000000000000000000000000000000000000001
101C0000000000000000000000000000000000000000000000000001
101C0000000000000000000000000000000000000000000000000001
101C0000000000000000000000000000000000000000000000000001
101C0000000000000000000000000000000000000000000000000001
101C0000000000000000000000000000000000000000000000000001
101C0000000000000000000000000000000000000000000000000001
101C0000000000000000000000000000000000000000000000000001
101C0000000000000000000000000000000000000000000000000001
101C0000000000000000000000000000000000000000000000000001
101C0000000000000000000000000000000000000000000000000001
101C0000000000000000000000000000000000000000000000000001
101C0000000000000000000000000000000000000000000000000001
101C0000000000000000000000000000000000000000000000000001
101C0000000000000000000000000000000000000000000000000001
101C0000000000000000000000000000000000000000000000000001
101C0000000000000000000000000000000000000000000000000001
101C0000000000000000000000000000000000000000000000000001
101C0000000000000000000000000000000000000000000000000001
101C0000000000000000000000000000000000000000000000000001
101C0000000000000000000000000000000000000000000000000001
101C0000000000000000000000000000000000000000000000000001
101C0000000000000000000000000000000000000000000000000001
101C0000000000000000000000000000000000000000000000000001
101C0000000000000000000000000000000000000000000000000001
101C0000000000000000000000000000000000000000000000000001
101C0000000000000000000000000000000000000000000000000001
101C0000000000000000000000000000000000000000000000000001
101C0000000000000000000000000000000000000000000000000001
101C0000000000000000000000000000000000000000000000000001
101C0000000000000000000000000000000000000000000000000001
101C0000000000000000000000000000000000000000000000000001
101C0000000000000000000000000000000000000000000000000001
101C0000000000000000000000000000000000000000000000000001
101C0000000000000000000000000000000000000000000000000001
101C0000000000000000000000000000000000000000000000000001
101C0000000000000000000000000000000000000000000000000001
101C0000000000000000000000000000000000000000000000000001
101C0000000000000000000000000000000000000000000000000001
101C0000000000000000000000000000000000000000000000000001
101C0000000000000000000000000000000000000000000000000001
101C0000000000000000000000000000000000000000000000000001
101C0000000000000000000000000000000000000000000000000001
101C0000000000000000000000000000000000000000000000000001
101C0000000000000000000000000000000000000000000000000001
101C0000000000000000000000000000000000000000000000000001
101C0000000000000000000000000000000000000000000000000001
101C0000000000000000000000000000000000000000000000000001
101C0000000000000000000000000000000000000000000000000001
101C0000000000000000000000000000000000000000000000000001
101C0000000000000000000000000000000000000000000000000001
101C0000000000000000000000000000000000000000000000000001
101C0000000000000000000000000000000000000000000000000001
101C0000000000000000000000000000000000000000000000000001
101C0000000000000000000000000000000000000000000000000001
101C0000000000000000000000000000000000000000000000000001
101C0000000000000000000000000000000000000000000000000001
101C0000000000000000000000000000000000000000000000000001
101C0000000000000000000000000000000000000000000000000001
101C0000000000000000000000000000000000000000000000000001
101C0000000000000000000000000000000000000000000000000001
101C0000000000000000000000000000000000000000000000000001
101C0000000000000000000000000000000000000000000000000001
101C0000000000000000000000000000000000000000000000000001
101C0000000000000000000000000000000000000000000000000001
101C0000000000000000000000000000000000000000000000000001
101C0000000000000000000000000000000000000000000000000001
101C0000000000000000000000000000000000000000000000000001
101C0000000000000000000000000000000000000000000000000001
101C0000000000000000000000000000000000000000000000000001
101C0000000000000000000000000000000000000000000000000001
101C0000000000000000000000000000000000000000000000000001
101C0000000000000000000000000000000000000000000000000001
101C0000000000000000000000000000000000000000000000000001
101C0000000000000000000000000000000000000000000000000001
101C0000000000000000000000000000000000000000000000000001
101C0000000000000000000000000000000000000000000000000001
101C0000000000000000000000000000000000000000000000000001
101C0000000000000000000000000000000000000000000000000001
101C0000000000000000000000000000000000000000000000000001
101C0000000000000000000000000000000000000000000000000001
101C0000000000000000000000000000000000000000000000000001
101C0000000000000000000000000000000000000000000000000001
101C0000000000000000000000000000000000000000000000000001
101C0000000000000000000000000000000000000000000000000001
101C0000000000000000000000000000000000000000000000000001
101C0000000000000000000000000000000000000000000000000001
101C0000000000000000000000000000000000000000000000000001
101C0000000000000000000000000000000000000000000000000001
101C0000000000000000000000000000000000000000000000000001
101C0000000000000000000000000000000000000000000000000001
101C0000000000000000000000000000000000000000000000000001
101C0000000000000000000000000000000000000000000000000001
101C0000000000000000000000000000000000000000000000000001
101C0000000000000000000000000000000000000000000000000001
101C0000000000000000000000000000000000000000000000000001
101C0000000000000000000000000000000000000000000000000001
101C0000000000000000000000000000000000000000000000000001
101C0000000000000000000000000000000000000000000000000001
101C0000000000000000000000000000000000000000000000000001
101C0000000000000000000000000000000000000000000000000001
101C0000000000000000000000000000000000000000000000000001
101C0000000000000000000000000000000000000000000000000001
101C0000000000000000000000000000000000000000000000000001
101C0000000000000000000000000000000000000000000000000001
101C0000000000000000000000000000000000000000000000000001
101C0000000000000000000000000000000000000000000000000001
101C0000000000000000000000000000000000000000000000000001
101C0000000000000000000000000000000000000000000000000001
101C0000000000000000000000000000000000000000000000000001
101C0000000000000000000000000000000000000000000000000001
101C0000000000000000000000000000000000000000000000000001
101C0000000000000000000000000000000000000000000000000001
101C0000000000000000000000000000000000000000000000000001
101C0000000000000000000000000000000000000000000000000001
101C0000000000000000000000000000000000000000000000000001
101C0000000000000000000000000000000000000000000000000001
101C0000000000000000000000000000000000000000000000000001
101C0000000000000000000000000000000000000000000000000001
101C0000000000000000000000000000000000000000000000000001
101C0000000000000000000000000000000000000000000000000001
101C0000000000000000000000000000000000000000000000000001
101C0000000000000000000000000000000000000000000000000001
101C0000000000000000000000000000000000000000000000000001
101C0000000000000000000000000000000000000000000000000001
101C0000000000000000000000000000000000000000000000000001
101C0000000000000000000000000000000000000000000000000001
101C0000000000000000000000000000000000000000000000000001
101C0000000000000000000000000000000000000000000000000001
101C0000000000000000000000000000000000000000000000000001
101C0000000000000000000000000000000000000000000000000001
101C0000000000000000000000000000000000000000000000000001
101C0000000000000000000000000000000000000000000000000001
101C0000000000000000000000000000000000000000000000000001
101C0000000000000000000000000000000000000000000000000001
101C0000000000000000000000000000000000000000000000000001
101C0000000000000000000000000000000000000000000000000001
101C0000000000000000000000000000000000000000000000000001
101C0000000000000000000000000000000000000000000000000001
101C0000000000000000000000000000000000000000000000000001
101C0000000000000000000000000000000000000000000000000001
101C0000000000000000000000000000000000000000000000000001
101C0000000000000000000000000000000000000000000000000001
101C0000000000000000000000000000000000000000000000000001
101C0000000000000000000000000000000000000000000000000001
101C0000000000000000000000000000000000000000000000000001
101C0000000000000000000000000000000000000000000000000001
101C0000000000000000000000000000000000000000000000000001
101C0000000000000000000000000000000000000000000000000001
101C0000000000000000000000000000000000000000000000000001
101C0000000000000000000000000000000000000000000000000001
101C0000000000000000000000000000000000000000000000000001
101C0000000000000000000000000000000000000000000000000001
101C0000000000000000000000000000000000000000000000000001
101C0000000000000000000000000000000000000000000000000001
101C0000000000000000000000000000000000000000000000000001
101C0000000000000000000000000000000000000000000000000001
101C0000000000000000000000000000000000000000000000000001
101C0000000000000000000000000000000000000000000000000001
101C0000000000000000000000000000000000000000000000000001
101C0000000000000000000000000000000000000000000000000001
101C0000000000000000000000000000000000000000000000000001
101C0000000000000000000000000000000000000000000000000001
101C0000000000000000000000000000000000000000000000000001
101C0000000000000000000000000000000000000000000000000001
101C0000000000000000000000000000000000000000000000000001
101C0000000000000000000000000000000000000000000000000001
101C0000000000000000000000000000000000000000000000000001
101C0000000000000000000000000000000000000000000000000001
101C0000000000000000000000000000000000000000000000000001
101C0000000000000000000000000000000000000000000000000001
101C0000000000000000000000000000000000000000000000000001
101C0000000000000000000000000000000000000000000000000001
101C0000000000000000000000000000000000000000000000000001
101C0000000000000000000000000000000000000000000000000001
101C0000000000000000000000000000000000000000000000000001
101C0000000000000000000000000000000000000000000000000001
101C0000000000000000000000000000000000000000000000000001
101C0000000000000000000000000000000000000000000000000001
101C0000000000000000000000000000000000000000000000000001
101C0000000000000000000000000000000000000000000000000001
101C0000000000000000000000000000000000000000000000000001
101C0000000000000000000000000000000000000000000000000001
101C0000000000000000000000000000000000000000000000000001
101C0000000000000000000000000000000000000000000000000001
101C0000000000000000000000000000000000000000000000000001
101C0000000000000000000000000000000000000000000000000001
101C0000000000000000000000000000000000000000000000000001
101C0000000000000000000000000000000000000000000000000001
101C0000000000000000000000000000000000000000000000000001
101C0000000000000000000000000000000000000000000000000001
101C0000000000000000000000000000000000000000000000000001
101C0000000000000000000000000000000000000000000000000001
101C0000000000000000000000000000000000000000000000000001
101C0000000000000000000000000000000000000000000000000001
101C0000000000000000000000000000000000000000000000000001
101C0000000000000000000000000000000000000000000000000001
101C0000000000000000000000000000000000000000000000000001
101C0000000000000000000000000000000000000000000000000001
101C0000000000000000000000000000000000000000000000000001
101C0000000000000000000000000000000000000000000000000001
101C0000000000000000000000000000000000000000000000000001
101C0000000000000000000000000000000000000000000000000001
101C0000000000000000000000000000000000000000000000000001
101C0000000000000000000000000000000000000000000000000001
101C0000000000000000000000000000000000000000000000000001
101C0000000000000000000000000000000000000000000000000001
101C0000000000000000000000000000000000000000000000000001
101C0000000000000000000000000000000000000000000000000001
101C0000000000000000000000000000000000000000000000000001
101C0000000000000000000000000000000000000000000000000001
101C0000000000000000000000000000000000000000000000000001
101C0000000000000000000000000000000000000000000000000001
101C0000000000000000000000000000000000000000000000000001
101C0000000000000000000000000000000000000000000000000001
101C0000000000000000000000000000000000000000000000000001
101C0000000000000000000000000000000000000000000000000001
101C0000000000000000000000000000000000000000000000000001
101C0000000000000000000000000000000000000000000000000001
101C0000000000000000000000000000000000000000000000000001
101C0000000000000000000000000000000000000000000000000001
101C0000000000000000000000000000000000000000000000000001
101C0000000000000000000000000000000000000000000000000001
101C0000000000000000000000000000000000000000000000000001
101C0000000000000000000000000000000000000000000000000001
101C0000000000000000000000000000000000000000000000000001
101C0000000000000000000000000000000000000000000000000001
101C0000000000000000000000000000000000000000000000000001
101C0000000000000000000000000000000000000000000000000001
101C0000000000000000000000000000000000000000000000000001
101C0000000000000000000000000000000000000000000000000001
101C0000000000000000000000000000000000000000000000000001
101C0000000000000000000000000000000000000000000000000001
101C0000000000000000000000000000000000000000000000000001
101C0000000000000000000000000000000000000000000000000001
101C0000000000000000000000000000000000000000000000000001
101C0000000000000000000000000000000000000000000000000001
101C0000000000000000000000000000000000000000000000000001
101C0000000000000000000000000000000000000000000000000001
101C0000000000000000000000000000000000000000000000000001
101C0000000000000000000000000000000000000000000000000001
101C0000000000000000000000000000000000000000000000000001
101C0000000000000000000000000000000000000000000000000001
101C0000000000000000000000000000000000000000000000000001
101C0000000000000000000000000000000000000000000000000001
101C0000000000000000000000000000000000000000000000000001
101C0000000000000000000000000000000000000000000000000001
101C0000000000000000000000000000000000000000000000000001
101C0000000000000000000000000000000000000000000000000001
101C0000000000000000000000000000000000000000000000000001
101C0000000000000000000000000000000000000000000000000001
101C0000000000000000000000000000000000000000000000000001
101C0000000000000000000000000000000000000000000000000001
101C0000000000000000000000000000000000000000000000000001
101C0000000000000000000000000000000000000000000000000001
101C0000000000000000000000000000000000000000000000000001
101C0000000000000000000000000000000000000000000000000001
101C0000000000000000000000000000000000000000000000000001
101C0000000000000000000000000000000000000000000000000001
101C0000000000000000000000000000000000000000000000000001
101C0000000000000000000000000000000000000000000000000001
101C0000000000000000000000000000000000000000000000000001
101C0000000000000000000000000000000000000000000000000001
101C0000000000000000000000000000000000000000000000000001
101C0000000000000000000000000000000000000000000000000001
101C0000000000000000000000000000000000000000000000000001
101C0000000000000000000000000000000000000000000000000001
101C0000000000000000000000000000000000000000000000000001
101C0000000000000000000000000000000000000000000000000001
101C0000000000000000000000000000000000000000000000000001
101C0000000000000000000000000000000000000000000000000001
101C0000000000000000000000000000000000000000000000000001
101C0000000000000000000000000000000000000000000000000001
101C0000000000000000000000000000000000000000000000000001
101C0000000000000000000000000000000000000000000000000001
101C0000000000000000000000000000000000000000000000000001
101C0000000000000000000000000000000000000000000000000001
101C0000000000000000000000000000000000000000000000000001
101C0000000000000000000000000000000000000000000000000001
101C0000000000000000000000000000000000000000000000000001
101C0000000000000000000000000000000000000000000000000001
101C0000000000000000000000000000000000000000000000000001
101C0000000000000000000000000000000000000000000000000001
101C0000000000000000000000000000000000000000000000000001
101C0000000000000000000000000000000000000000000000000001
101C0000000000000000000000000000000000000000000000000001
101C0000000000000000000000000000000000000000000000000001
101C0000000000000000000000000000000000000000000000000001
101C0000000000000000000000000000000000000000000000000001
101C0000000000000000000000000000000000000000000000000001
101C0000000000000000000000000000000000000000000000000001
101C0000000000000000000000000000000000000000000000000001
101C0000000000000000000000000000000000000000000000000001
101C0000000000000000000000000000000000000000000000000001
101C0000000000000000000000000000000000000000000000000001
101C0000000000000000000000000000000000000000000000000001
101C0000000000000000000000000000000000000000000000000001
101C0000000000000000000000000000000000000000000000000001
101C0000000000000000000000000000000000000000000000000001
101C0000000000000000000000000000000000000000000000000001
101C0000000000000000000000000000000000000000000000000001
101C0000000000000000000000000000000000000000000000000001
101C0000000000000000000000000000000000000000000000000001
101C0000000000000000000000000000000000000000000000000001
101C0000000000000000000000000000000000000000000000000001
101C0000000000000000000000000000000000000000000000000001
101C0000000000000000000000000000000000000000000000000001
101C0000000000000000000000000000000000000000000000000001
101C0000000000000000000000000000000000000000000000000001
101C0000000000000000000000000000000000000000000000000001
101C0000000000000000000000000000000000000000000000000001
101C0000000000000000000000000000000000000000000000000001
101C0000000000000000000000000000000000000000000000000001
101C0000000000000000000000000000000000000000000000000001
101C0000000000000000000000000000000000000000000000000001
101C0000000000000000000000000000000000000000000000000001
101C0000000000000000000000000000000000000000000000000001
101C0000000000000000000000000000000000000000000000000001
101C0000000000000000000000000000000000000000000000000001
101C0000000000000000000000000000000000000000000000000001
101C0000000000000000000000000000000000000000000000000001
101C0000000000000000000000000000000000000000000000000001
101C0000000000000000000000000000000000000000000000000001
101C0000000000000000000000000000000000000000000000000001
101C0000000000000000000000000000000000000000000000000001
101C0000000000000000000000000000000000000000000000000001
101C0000000000000000000000000000000000000000000000000001
101C0000000000000000000000000000000000000000000000000001
101C0000000000000000000000000000000000000000000000000001
101C0000000000000000000000000000000000000000000000000001
101C0000000000000000000000000000000000000000000000000001
101C0000000000000000000000000000000000000000000000000001
101C0000000000000000000000000000000000000000000000000001
101C0000000000000000000000000000000000000000000000000001
101C0000000000000000000000000000000000000000000000000001
101C0000000000000000000000000000000000000000000000000001
101C0000000000000000000000000000000000000000000000000001
101C0000000000000000000000000000000000000000000000000001
101C0000000000000000000000000000000000000000000000000001
101C0000000000000000000000000000000000000000000000000001
101C0000000000000000000000000000000000000000000000000001
101C0000000000000000000000000000000000000000000000000001
101C0000000000000000000000000000000000000000000000000001
101C0000000000000000000000000000000000000000000000000001
101C0000000000000000000000000000000000000000000000000001
101C0000000000000000000000000000000000000000000000000001
101C0000000000000000000000000000000000000000000000000001
101C0000000000000000000000000000000000000000000000000001
101C0000000000000000000000000000000000000000000000000001
101C0000000000000000000000000000000000000000000000000001
101C0000000000000000000000000000000000000000000000000001
101C0000000000000000000000000000000000000000000000000001
101C0000000000000000000000000000000000000000000000000001
101C0000000000000000000000000000000000000000000000000001
101C0000000000000000000000000000000000000000000000000001
101C0000000000000000000000000000000000000000000000000001
101C0000000000000000000000000000000000000000000000000001
101C0000000000000000000000000000000000000000000000000001
101C00000000000000000000000000000000000000000000000000E1
11111111111111111111111111111111111111111111111111111111
