111111111111111111111111111111111111
1000000000000000000000C0000000000001
100000000000000000000000000000C00001
100000P00000000000000000000000000001
100000C00000000000000000000000000001
100000000000000000C00000000000000001
100000000000000000000000000000000001
100000000000000000000000000000000001
10000C000000000000000000000000000001
100000000000100000000000000000000001
100000000000000000000000000000000001
100000000000000000000000000000000001
100000000000000000000000000000000001
1000C0000000000000C00000000000E00001
100000000000000000000000000C00000001
111111111111111111111111111111111111
