111111
1P0001
100E01
10C001
111111
