11111111
1P1C0101
100E0C11
10C00C01
1000CC01
11111111
