11111111
1P0C0001
100E0C01
10C00C01
1000CC01
11111111
